veux	vouloir
voudrais	vouloir
articles	article
pages	page
en	en
par	par
sur	sur
parle	sur
parlent	sur
ecrits	stop
ecrit	stop
le 	stop
les	stop
la	stop
de	stop
des	stop
du	stop
je	stop
est	stop
je	stop
Je	stop
tous	stop
toutes	stop
qui	stop
